Rd, Gg, Gll, Gg, Gg, Gg, Gll, Gll, Gll^Fp, Gg, Gg, Gg, Gg, Gg, Ww, Wo, Wo, Ww, Gll^Fp, Gll^Fp, Gg, Gll, Gll, Gg, Gll^Fp, Gll^Fp, Gg, Gg, Gd, Gg, Gg, Gg, Gg, Gg
Gll, Rd, Hh, Gg, Gll^Fp, Gll^Fp, Gll, Gll, Gll^Fp, Gll^Fp, Gg, Gg^Ve, Gll, Ss, Ww, Ww, Ww, Ww, Ss^Vhs, Gll^Fp, Hh, Ss, Gg, Gll^Fp, Gll^Fp, Gg, Gd, Gd, Gd, Gd, Gg, Gd, Gd, Gg
Gll, Hh, Gg^Ve, Rd, Gll^Fp, Gg, Gll, Hh, Ss, Gll, Gll, Ss, Ss, Ww, Wo, Wo, Ww, Ww, Ce, Gg, Ce, Hh, Gg, Gg, Hh, Gg, Gll, Gg, Gll^Fp, Gll^Fp, Gg, Gg, Gd, Gg
Gg, Gg, Gll^Fp, Rd, Rd, Rd, Rd, Hh, Gll, Gll, Gll, Ss, Ww, Wo, Ww, Ww, Ce, Ce, Gg, Gg, Gg, Ce, Ce, Gd^Vo, Gd, Hh, Gg, Gll, Gll^Fp, Gll^Fp, Gg, Gg, Gg, Gd
Gg, Gll^Fp, Gll^Fp, Hh, Gg^Ve, Gll^Fp, Gg, Rd, Cvr, Gll, Ww, Ww, Wo, Ww, Ww, Gd, Gg, Gg, Gg, Gg, Gg, Gg, Gg, Gg, Gd, Gd, Gg, Gll^Fp, Gg, Gll^Fp, Gll^Fp, Gd^Vo, Gg, Gg
Gll, Gll, Hh, Gg, Gg, Gll^Fp, Gg, Rd, Ww^Bw\r, Ww, Wo, Wo, Ww, Ww, Gd, Ce, Gd, Gg, Ce, Ce, Ce, Gd, Gg, Ce, Gd, Gg, Gll, Gll^Fp, Gll^Fp, Gg, Gll^Fp, Gll^Fp, Gd, Gd
Gg, Ss, Gg, Ss, Ss, Ww, Ww, Cvr, Ww, Ww^Bw\r, Wo^Bw\r, Ww, Cvr, Gd, Gll, Ce, Gd, Gd, Ce, 2 Ke, Ce, Gd, Gg, Ce, Gg, Gg, Gll, Gg, Gg, Gll^Fp, Gg, Gll^Fp, Gg, Gg
Gg, Gll^Fp, Ww, Ww, Wo, Ww, Wo, Ww, Wo, Ww, Ww, Ww^Bw\r, Rd, Gd^Vo, Gll, Ce, Gg, Gd, Gg, Ce, Gg, Gg, Gg, Ce, Gg, Gg, Gg, Gg, Gll, Gd, Gd, Gg, Gll^Fp, Gg
Ww, Ww, Wo, Ww, Ww, Wo, Ww, Wo, Ss, Ww, Gg, Cvr, Gg, Rd, Rd, Gg, Ce, Gg, Gg, Gg, Gg, Gd^Vo, Ce, Gg, Gd, Gd, Gll^Fp, Gg, Hh, Gg, Gg, Gll^Fp, Gg, Gg
Wo, Wo, Ww, Ww, Gg, Ww, Gg, Ss, Gg, Gg, Ss, Gg, Gd, Gd, Gg, Rd, Rd, Ce, Ce, Gg, Ce, Ce, Gg, Gg, Gll, Gll^Fp, Gg, Hh, Gg, Gll, Gd, Gd, Gll, Gg
Ww, Ss, Ss, Gg, Gd^Vo, Gg, Gg, Gll^Fp, Gll^Fp, Gd, Gd, Gg, Gd, Gll^Fp, Gll^Fp, Gll^Fp, Gg, Rd, Gd, Gg, Gg, Gg, Gd, Gd, Gll, Gll^Fp, Gll^Fp, Gg, Gg, Gll^Fp, Gll^Fp, Gll, Gll, Gg
Gg, Gg, Gg, Gg, Gll^Fp, Gg, Gg, Gll^Fp, Gll, Gll, Gg, Gg, Gg, Gll^Fp, Gll^Fp, Gll^Fp, Hh, Rd, Gd, Gd, Gg, Gd, Gll^Fp, Gg, Gg, Gll^Fp, Gg, Gg, Gd^Vo, Gll^Fp, Gg, Gll, Gg, Gg
Gg, Ss, Gg, Gll^Fp, Gll^Fp, Gll^Fp, Gg, Gg, Gg, Gll, Gd, Hh, Gg, Gd, Gd, Gg, Hh, Rd, Rd, Gg, Gll^Fp, Gll^Fp, Gg, Gg, Gll^Fp, Gg, Gll, Gll, Gg, Gg, Gg, Hh, Gll^Fp, Gg
Gg, Gg, Hh, Gg, Gg, Gll^Fp, Gg, Gg, Gg^Ve, Gg, Gg, Hh, Gll^Fp, Gg, Gd, Gd, Gg, Hh, Gg, Rd, Gll^Fp, Gg, Gg, Gg, Gll^Fp, Gd, Gg, Gg, Gll, Gg, Gg, Gll^Fp, Gg, Gll^Fp
Gg, Gg, Gg, Gg, Gg, Hh, Gg, Gg, Gll^Fp, Gg, Gg, Gg, Gll^Fp, Gll^Fp, Gg, Gd, Gll, Gd, Gg, Gll^Fp, Rd, Gg, Gll, Gg, Gd, Gd, Gg, Gll, Gg, Gg, Gg, Gll, Gll, Gg
Gg, Gg, Gg, Gll, Gll, Gll, Gg, Gll^Fp, Gg, Gg, Gg, Gll^Fp, Gll^Fp, Gll^Fp, Gg, Gg, Gg, Gg, Gg, Gg, Gll^Fp, Rd, Rd, Gg, Gg, Gg, Gg, Gg, Gll^Fp, Gll^Fp, Gll^Fp, Gg, Gg, Gg
Gg, Gg^Ve, Gg, Gg, Gg, Gg, Hh, Gll^Fp, Gg, Gg, Gg, Gg, Gg, Gll^Fp, Gg, Gg^Ve, Gll, Hh, Hh, Gg, Gll^Fp, Gll, Rd, Gg, Gg, Gg, Gg, Gll, Hh, Gll^Fp, Gll^Fp, Gll^Fp, Gg, Gg
Gg, Gg, Gg, Gg, Gg, Gg, Gll, Gg, Gg, Gg, Gll^Fp, Gg, Gll^Fp, Gg, Gll^Fp, Gg, Gll, Gg, Hh, Gg, Gg, Gg, Gg, Rd, Cv, Gg, Gg, Gll, Gg, Gll, Gg, Gll^Fp, Gg, Gg
Gg, Gg, Gll^Fp, Hh, Gg, Gg, Gll, Gg, Gg, Gg, Gg, Gll^Fp, Gg, Gll^Fp, Gll^Fp, Gg, Gg, Hh, Gg, Gg, Gg, Gg, Gg, Cv, 1 Kv, Cv, Gg, Gg, Gg, Gg, Gll, Gg, Gg, Gg
Gg, Gg, Gll^Fp, Hh, Gg, Gll, Gg, Gg^Ve, Gg, Gll^Fp, Gll^Fp, Gg, Hh, Gg, Gg, Gg, Gg, Gll^Fp, Gg, Gg, Gg, Gg, Gg, Cv, Cv, Cv, Rd, Gg, Gg, Gg^Ve, Gll, Gll, Gg, Gg
Gg, Gll^Fp, Gg, Gll, Gll, Gg, Gll, Gg, Gg, Gg, Gg, Gll^Fp, Gll^Fp, Gg, Gll, Gg, Gll^Fp, Gll^Fp, Hh, Gg, Gg, Gg, Gg, Gg, Gg, Gg, Gg, Rd, Gll^Fp, Gll^Fp, Gll^Fp, Gll, Gg, Gg
Gg, Gg, Gg, Gll, Gg, Gll, Gg, Gg, Gg, Gg, Gll, Gll, Gg, Gll, Gg, Gg, Gll^Fp, Gg, Gg, Gg, Gg, Gg^Ve, Gg, Gg, Gg, Gg, Gg, Rd, Gll^Fp, Gll^Fp, Gll^Fp, Gll^Fp, Gll, Gg
Gg, Gg, Gg, Gg, Gg, Gg, Gg, Gg, Gg, Gg, Gg, Gll, Gg, Gll, Gg, Gg, Gg, Gg, Gg, Gg, Gg, Gg, Gg, Gg, Gg, Gg, Gg, Rd, Rd, Gg, Gg, Gll, Gg, Gg
